0 1 1 -1 -1 -1 -1 -1 -1 -1 -1 -1 -1 -1 -1
1 0 -1 1 -1 1 1 -1 -1 -1 -1 -1 -1 -1 -1
1 -1 0 1 1 -1 -1 -1 -1 -1 -1 -1 -1 -1 -1
-1 1 1 0 1 1 -1 -1 -1 -1 -1 -1 -1 -1 -1
-1 -1 1 1 0 -1 -1 -1 -1 -1 -1 -1 -1 -1 -1
-1 1 -1 1 -1 0 1 1 1 1 -1 -1 -1 -1 -1
-1 1 -1 -1 -1 1 0 1 -1 -1 -1 -1 -1 -1 -1
-1 1 -1 -1 -1 1 1 0 -1 -1 -1 1 -1 -1 -1
-1 -1 -1 -1 -1 1 -1 -1 0 -1 -1 1 -1 -1 -1
-1 -1 -1 -1 -1 -1 -1 1 -1 0 1 1 -1 -1 -1
-1 -1 -1 -1 -1 -1 -1 -1 -1 1 0 1 1 -1 -1
-1 -1 -1 -1 -1 -1 -1 1 1 1 1 0 -1 1 1
-1 -1 -1 -1 -1 -1 -1 -1 -1 -1 -1 1 -1 0 1
-1 -1 -1 -1 -1 -1 -1 -1 -1-1 -1 1 -1 1 0
from top to bottom:
NPB
Reitz
Weil
Waimar
Stadium
HUB
Marston
Turlington
Chem
Auditorium
Carleton
West
Little Hall
Matherly
Heavener